8,6,6,6,6,6,6,6,6,6,6,6,6,1,1,3,3,4,4,4,4,4,2,3,3,3,3,3,3,3,2,2,2,2,2,1,1,1,1,1,1,1,1,1,1,4,4,4,4,4,4,4,4,4,4,4,4,4,4,4,4,4,7,8
8,6,6,6,6,6,6,6,6,6,6,6,6,1,1,3,3,4,4,5,5,4,2,3,3,3,3,3,3,3,2,2,2,2,1,1,1,1,1,1,1,1,1,1,1,4,4,4,4,4,4,4,4,4,4,4,4,4,4,4,4,4,7,8
8,6,6,6,6,6,6,6,6,6,6,6,6,1,1,3,3,4,4,5,5,4,4,2,2,0,0,0,3,3,2,2,2,2,2,1,1,1,7,7,1,1,1,7,7,7,4,4,4,4,4,4,4,4,5,5,5,5,5,5,4,4,7,8
8,0,0,0,0,0,6,6,6,6,6,6,6,1,1,3,3,4,4,5,5,5,4,4,4,0,0,0,3,2,2,2,2,2,2,1,1,1,7,7,1,1,7,7,7,7,7,7,4,4,4,4,4,4,5,5,5,5,5,4,4,4,7,8
8,0,0,0,0,0,0,0,0,0,0,0,6,1,1,3,3,4,5,5,5,5,5,4,4,0,0,0,3,3,2,1,1,1,1,1,1,1,7,7,7,7,7,7,7,7,7,7,7,4,4,4,6,6,6,6,6,6,6,4,4,4,7,8
8,6,6,6,6,6,6,6,6,6,6,0,6,1,1,3,3,4,4,4,5,5,5,4,4,0,0,0,3,3,2,1,1,1,1,1,1,1,7,1,7,7,7,7,7,7,7,7,7,4,4,6,6,6,6,6,6,6,4,4,7,7,7,8
8,6,6,6,6,6,6,6,6,6,6,0,6,1,1,3,3,4,4,4,4,4,4,4,4,0,0,0,3,3,2,1,1,1,1,1,1,1,1,1,7,7,7,7,7,7,7,7,7,4,6,6,6,6,6,6,6,6,6,7,7,7,7,8
8,6,6,6,6,6,6,6,6,6,6,0,6,1,1,3,3,3,3,3,3,3,3,3,0,0,0,0,3,3,2,1,1,1,1,1,1,1,1,7,7,7,7,7,7,7,7,7,7,6,6,6,6,6,6,6,6,6,6,7,7,7,7,8
8,6,6,6,6,6,6,6,6,6,6,0,0,0,0,0,1,1,1,1,1,1,1,1,0,0,0,2,3,3,1,1,1,1,1,1,1,1,7,7,7,7,7,7,7,7,7,7,6,6,6,6,6,6,6,6,6,6,6,7,7,7,7,8
8,1,1,6,6,6,6,6,6,1,1,1,1,1,1,0,1,1,1,1,1,1,1,1,0,2,2,2,3,3,2,1,1,1,1,1,1,1,1,1,1,1,1,1,1,1,1,1,6,6,6,6,6,6,6,6,6,6,6,6,6,7,6,8
8,1,1,1,1,1,1,1,1,1,1,1,1,1,1,0,0,0,0,0,0,0,0,0,0,2,2,2,2,2,2,3,3,3,3,1,2,1,1,1,1,1,1,1,1,1,1,1,6,6,6,6,6,6,6,6,6,6,6,6,6,6,6,8
8,2,2,2,2,2,2,2,2,2,2,2,6,6,6,0,6,6,6,6,6,6,6,0,0,2,2,2,2,2,2,2,2,3,3,1,2,1,1,1,1,1,1,0,0,0,0,0,6,6,6,6,6,6,6,6,6,6,6,6,6,6,1,8
8,2,2,2,2,2,2,2,2,2,2,2,6,1,1,0,6,6,1,1,1,1,6,0,0,2,2,2,2,2,2,2,3,3,3,1,1,2,1,0,0,0,0,0,0,0,0,0,6,6,6,6,6,6,6,6,6,6,1,1,1,1,1,8
8,2,2,2,2,2,2,2,2,2,2,2,1,1,1,0,6,6,1,1,1,1,6,0,0,2,2,2,3,3,3,3,3,3,3,3,1,2,0,0,0,0,0,0,0,0,7,7,6,6,6,6,6,6,6,6,6,6,2,2,2,2,2,8
8,2,2,2,2,2,2,2,2,2,2,2,1,1,1,0,6,6,1,1,1,1,6,0,0,2,2,2,3,3,3,3,3,3,3,3,1,2,0,0,0,7,7,7,7,7,7,7,6,6,6,6,6,6,6,6,6,2,2,2,2,2,2,8
8,2,2,2,2,2,2,2,2,2,2,2,1,1,1,0,6,6,1,1,1,1,6,0,0,2,2,3,3,3,3,3,3,3,3,3,1,2,0,0,0,7,7,7,7,7,7,7,7,7,6,6,6,6,6,6,1,2,2,2,2,2,2,8
8,3,2,2,2,2,2,2,2,2,2,1,1,1,1,0,6,6,6,6,6,1,6,0,0,3,3,3,3,3,3,3,3,3,3,3,1,2,0,0,0,7,7,7,7,7,7,7,7,7,6,6,6,6,6,6,1,1,2,2,2,2,2,8
8,3,3,3,3,2,2,2,1,1,1,1,1,1,1,0,0,0,0,0,6,6,6,0,0,0,0,0,0,0,0,0,0,0,0,3,1,2,0,0,7,7,7,7,7,7,7,7,7,7,7,6,6,6,6,6,1,1,2,2,2,2,2,8
8,3,3,3,3,3,2,2,2,2,1,2,2,2,2,2,0,0,0,0,0,0,0,0,0,0,0,0,0,0,0,0,0,0,0,0,1,2,0,0,7,7,7,4,4,7,7,7,7,7,7,6,6,6,6,6,6,2,2,2,2,2,2,8
8,3,3,3,3,3,2,2,2,2,2,2,3,6,6,6,6,6,6,6,6,6,2,2,0,0,0,0,0,0,0,0,0,0,0,0,1,2,0,0,7,7,4,4,4,7,7,7,7,7,7,6,6,6,3,3,2,2,2,2,2,2,2,8
8,3,3,3,3,3,3,2,2,2,2,3,3,2,2,2,2,2,2,2,2,2,2,2,0,0,0,0,0,0,0,0,0,0,0,0,1,2,0,2,2,2,4,4,4,2,2,2,2,2,2,6,1,1,3,2,2,2,2,2,2,2,2,8
8,3,3,3,3,3,3,3,2,2,3,3,3,2,2,2,8,8,8,8,8,2,8,8,0,0,0,0,0,0,0,0,0,0,0,8,0,2,2,2,2,2,4,2,2,2,2,2,2,2,1,1,1,1,3,3,3,3,3,3,3,3,3,8
8,3,3,3,3,3,3,3,3,3,3,3,3,4,4,0,0,0,0,0,0,0,0,0,0,0,0,0,0,0,0,0,0,0,0,8,0,1,1,1,1,1,4,1,1,1,1,1,1,1,1,1,1,1,3,3,3,3,3,3,3,3,3,8
8,3,3,3,7,7,7,7,7,7,7,7,4,4,4,4,6,6,0,0,0,0,0,0,0,0,0,0,0,0,0,0,0,0,0,0,0,0,0,1,1,1,4,4,4,4,4,4,4,4,1,1,1,1,2,3,3,3,3,3,3,3,3,8
8,3,3,7,7,7,7,7,7,7,7,7,7,4,5,4,6,6,0,0,0,0,0,0,0,0,0,0,0,0,0,0,0,0,0,0,0,0,0,1,2,2,1,1,4,4,4,4,4,4,1,1,1,1,2,3,3,3,3,3,3,3,3,8
8,3,3,7,7,7,7,7,7,7,7,7,4,4,5,4,6,6,0,0,0,0,0,0,0,0,0,0,0,0,0,0,0,0,0,0,0,0,0,1,2,2,2,1,1,1,1,1,1,4,1,1,1,1,2,3,3,3,3,3,3,3,3,8
8,3,3,7,7,7,7,7,7,7,7,7,7,4,5,5,6,6,0,0,0,0,0,0,0,0,0,0,0,0,0,0,0,0,0,0,0,0,0,1,2,2,2,2,2,2,2,1,4,4,1,1,1,2,2,2,3,3,3,3,3,3,3,8
8,7,7,7,7,7,7,7,7,7,7,7,5,5,5,5,2,2,0,0,0,0,0,0,0,0,0,0,0,0,0,0,0,0,0,0,0,0,0,1,2,2,0,0,0,0,0,4,0,0,0,1,1,2,2,2,3,3,3,3,2,3,3,8
8,7,7,7,7,7,7,7,7,7,7,7,7,7,7,7,2,2,4,0,0,0,0,0,0,0,0,0,0,0,0,0,0,0,0,0,0,0,0,1,2,2,0,3,3,3,0,4,0,0,0,0,1,2,2,2,2,2,2,2,2,3,3,8
8,7,7,7,7,7,7,7,7,7,7,7,7,7,7,7,2,4,4,0,0,0,0,0,0,0,0,0,0,0,0,0,0,0,0,0,0,0,1,1,2,2,0,3,3,3,0,4,4,4,0,0,1,2,2,2,2,3,2,2,2,2,3,8
8,7,7,7,7,7,7,7,7,7,7,7,7,3,3,4,4,4,4,0,0,0,0,0,0,0,0,0,0,0,0,0,0,0,0,2,0,0,0,0,0,0,0,3,3,3,0,1,4,4,0,0,1,2,2,2,2,3,3,2,2,2,3,8
8,7,7,7,7,7,7,7,7,7,7,7,7,2,2,4,4,4,1,1,1,1,1,1,1,1,1,1,1,1,1,1,1,1,1,2,2,3,3,3,3,3,3,3,3,3,0,0,0,0,0,0,4,2,2,2,3,3,3,3,2,2,2,8
8,7,7,7,7,7,7,7,7,7,7,7,7,2,4,4,4,1,1,1,1,1,1,1,1,1,1,1,1,1,1,1,1,1,1,2,2,2,2,3,3,3,3,3,3,3,3,3,4,4,4,4,4,6,2,2,3,3,3,3,2,2,2,8
8,7,7,7,7,7,7,7,7,7,7,7,7,4,4,4,1,1,1,1,1,1,1,1,1,1,1,1,1,1,1,1,1,1,1,2,2,4,4,6,3,3,3,3,3,3,3,3,3,3,6,4,4,6,2,2,2,3,3,2,2,6,6,8
8,7,7,7,7,7,7,7,7,7,7,7,2,2,4,4,4,1,1,1,1,1,1,1,1,1,1,1,1,1,1,1,1,4,4,4,4,4,4,6,6,6,6,6,6,6,6,6,6,6,6,4,4,6,2,2,2,2,2,2,6,6,6,8
8,7,7,7,7,7,7,1,1,1,1,1,1,1,1,4,4,1,1,1,1,1,1,1,1,1,1,1,1,1,1,4,4,4,5,5,5,5,4,6,6,6,6,6,6,6,6,6,6,6,6,4,4,6,6,6,6,6,6,6,6,6,6,8
8,3,3,7,7,7,7,1,1,1,1,1,1,1,1,1,4,4,1,1,1,1,4,4,4,1,1,1,4,4,4,4,5,5,5,5,5,4,4,6,6,6,6,6,6,6,6,6,6,6,6,4,4,6,6,6,6,6,6,6,6,6,6,8
8,3,3,3,3,3,3,3,1,1,1,1,1,1,1,1,4,4,4,4,4,4,4,4,4,4,4,4,5,5,5,5,5,5,5,5,4,5,5,4,6,6,6,6,6,6,6,6,6,6,6,4,4,6,6,6,6,6,6,6,6,6,6,8
8,3,3,3,3,3,3,3,1,1,1,1,1,4,4,4,4,4,4,4,5,5,5,5,5,5,5,5,5,5,5,5,5,5,5,5,4,5,5,4,6,6,6,6,6,6,6,6,6,6,6,4,4,6,6,6,6,6,6,6,6,6,6,8
8,3,3,3,3,3,3,3,3,4,4,4,4,5,5,5,5,5,4,4,5,5,5,5,5,5,5,5,5,5,5,5,5,5,5,5,4,4,4,4,4,6,6,6,6,6,6,6,6,6,4,4,5,5,6,0,0,0,0,0,4,4,4,8
8,3,3,3,3,3,4,4,4,5,5,5,5,5,5,5,5,5,4,4,5,5,5,5,5,5,5,5,5,5,5,5,5,5,5,5,4,4,4,4,4,6,6,6,6,6,6,6,6,6,4,4,5,5,0,0,4,4,0,0,4,5,5,8
8,3,3,3,3,4,4,5,5,5,5,5,5,5,5,5,5,5,5,5,5,5,5,5,5,5,5,5,5,5,5,5,5,5,5,5,4,4,4,4,4,4,4,6,6,6,6,6,6,4,4,4,4,5,0,0,4,4,0,0,4,5,5,8
8,3,4,4,4,5,5,5,5,5,5,5,5,5,5,5,5,5,5,5,5,5,5,5,5,5,5,5,5,5,5,5,5,5,5,5,5,5,5,5,5,5,4,4,4,4,4,4,4,4,5,5,5,5,0,0,4,4,0,0,4,5,5,8
8,4,4,5,5,5,5,5,5,5,5,5,5,5,5,5,5,5,5,5,5,5,5,5,5,5,5,5,5,5,5,5,5,5,5,5,5,5,5,5,5,5,5,5,5,5,5,5,5,5,5,5,5,5,0,0,4,4,0,0,4,5,5,8
8,5,5,5,5,5,5,5,5,5,5,5,5,5,5,5,5,5,5,5,5,5,5,5,5,5,5,5,5,5,5,5,5,5,5,5,5,5,5,5,5,5,5,5,5,5,5,5,5,5,5,5,5,5,0,0,0,0,0,0,4,5,5,8
8,5,5,5,5,5,5,5,5,5,5,5,5,5,5,5,5,5,5,5,5,5,5,5,5,5,5,5,5,5,5,5,5,5,5,5,5,5,5,5,5,5,5,5,5,5,5,5,5,5,5,5,5,4,0,0,4,4,0,0,4,5,5,8
8,5,5,5,5,5,5,5,5,5,5,5,5,5,5,5,5,5,5,5,5,5,5,5,5,5,5,5,5,5,5,5,5,5,5,5,5,5,5,5,5,5,5,5,5,5,5,5,5,5,5,5,5,4,0,0,4,4,0,0,4,5,5,8
8,5,4,5,5,5,5,5,5,5,5,5,5,5,5,5,5,5,5,5,5,5,5,5,5,5,5,5,5,5,5,5,5,5,5,5,5,5,5,5,5,5,5,5,5,5,5,5,5,5,5,5,5,4,0,0,4,4,0,0,4,4,4,8
8,5,4,4,5,5,5,5,5,5,5,5,5,5,5,5,5,5,5,5,5,5,5,5,5,5,5,5,5,5,5,5,5,5,5,5,5,5,5,5,5,5,5,5,5,5,5,5,5,5,5,5,5,4,0,0,4,4,0,0,0,0,0,8
8,4,6,4,4,4,5,5,5,5,5,5,5,5,5,5,5,5,5,5,5,5,5,5,5,5,5,5,5,5,5,5,5,5,5,5,5,5,5,5,5,5,5,5,5,5,5,5,5,5,5,5,5,4,0,0,4,4,0,0,0,0,0,8
8,4,6,6,6,4,4,4,4,5,5,5,5,5,5,5,5,5,5,5,5,5,5,5,5,5,5,4,4,4,4,4,4,5,4,4,4,5,5,5,5,5,5,5,5,5,5,5,5,5,5,4,4,4,4,4,4,4,4,4,4,4,4,8
8,4,6,1,1,6,6,6,4,5,5,5,5,5,5,5,5,5,5,5,5,5,5,4,4,5,5,4,6,6,6,6,4,4,4,4,4,4,4,4,4,4,4,5,5,5,5,5,5,5,5,5,5,4,4,4,4,5,5,5,5,5,5,8
8,4,6,1,1,1,1,6,4,5,5,5,5,5,5,5,5,5,5,5,5,5,5,6,4,5,5,4,6,2,2,1,6,4,6,6,6,6,4,4,4,4,4,5,5,5,5,5,5,5,5,5,5,5,5,5,5,5,5,5,5,5,5,8
8,6,6,2,2,2,1,6,6,4,4,5,5,5,5,5,5,5,5,5,5,5,5,6,6,4,4,4,6,2,2,1,6,6,6,4,4,4,6,6,6,6,4,5,5,5,5,5,5,5,5,5,5,5,5,5,5,5,5,5,5,5,5,8
8,2,2,2,2,2,1,1,1,6,4,5,5,5,5,5,5,5,5,5,5,4,4,6,6,6,6,6,6,2,1,1,6,6,6,4,4,4,4,4,4,6,4,4,4,4,5,5,5,5,5,5,5,5,5,5,5,5,5,5,5,5,5,8
8,2,2,2,2,2,1,1,1,6,4,5,5,5,5,5,5,5,5,5,5,4,6,3,3,3,3,3,3,2,2,2,2,6,6,6,6,4,5,4,4,6,6,6,6,4,4,5,5,5,5,5,5,5,5,5,5,5,5,5,5,5,5,8
8,6,6,6,6,2,1,1,1,6,4,5,5,5,5,5,5,5,5,5,5,4,6,3,3,3,3,3,3,2,2,3,2,6,6,6,6,4,5,5,6,6,2,2,1,6,4,5,5,5,5,5,5,5,5,5,4,4,4,5,5,5,5,8
8,4,4,4,6,6,6,6,6,4,5,5,5,5,5,5,5,4,4,4,4,4,6,3,3,3,3,3,3,3,3,3,2,6,5,5,5,4,5,5,6,1,2,2,1,6,4,4,4,4,4,5,5,5,5,4,4,6,4,5,5,5,5,8
8,5,5,4,4,4,4,4,4,5,5,5,5,5,5,4,4,6,6,6,6,6,6,3,3,3,3,3,3,3,3,3,2,6,5,5,5,5,4,5,6,2,2,2,2,6,6,6,6,6,4,4,5,5,4,6,6,6,6,4,4,4,4,8
8,5,5,5,5,5,5,5,5,5,5,4,4,4,6,6,6,6,3,3,3,3,3,3,3,3,3,3,3,3,3,3,2,6,5,5,5,5,4,6,2,2,2,2,2,1,1,1,1,1,6,6,4,4,4,6,1,1,6,4,4,4,4,8
8,5,5,5,5,5,5,5,5,5,5,4,6,6,6,3,3,3,7,7,7,7,3,3,3,3,3,3,3,3,3,3,2,6,4,4,4,4,4,6,2,2,2,2,2,2,2,2,2,2,2,1,6,6,6,6,1,1,6,6,6,6,6,8
8,4,4,4,4,4,4,5,5,5,5,4,6,7,7,3,3,3,3,7,7,7,7,3,3,3,3,3,3,3,3,2,2,6,6,6,6,6,6,2,2,2,2,2,2,2,2,2,2,1,1,1,1,1,1,1,1,1,1,1,1,1,1,8
8,4,4,4,4,4,4,4,4,4,4,6,6,7,7,7,7,7,7,7,7,7,7,3,3,3,3,3,3,3,3,2,2,2,2,2,2,2,2,2,2,2,2,2,2,2,2,1,1,1,1,1,1,1,1,1,1,1,1,1,1,1,1,8
8,6,6,6,6,6,6,6,6,6,6,6,7,7,7,7,7,7,7,7,7,7,7,7,7,3,3,3,1,1,1,1,1,1,1,1,1,1,1,1,1,1,1,1,1,1,1,1,1,1,1,1,1,1,1,1,1,1,1,1,1,1,1,8