1,1,1,1,1,1,1,1,1,1,1,1,1,1,1,1,1,1,1,1,1,1,1,1,1,1,1,1,1,1,1,1,1,1,1,1,1,1,1,1,1,1,1,1,1,1,1,1,1,1,1,1,1,1,1,1,1,1,1,1,1,1,1,1
1,1,1,1,1,1,1,1,1,1,1,1,1,1,1,1,1,1,1,1,1,1,1,1,1,1,1,1,1,1,1,7,7,7,1,1,1,1,1,1,1,1,1,1,1,1,1,1,1,1,1,1,1,1,1,1,1,1,1,1,1,1,1,1
1,1,1,1,1,1,1,1,1,1,1,1,1,1,1,1,1,1,1,1,1,1,1,1,1,1,1,1,1,1,1,7,7,7,1,1,1,1,1,1,1,1,1,1,1,1,1,1,1,1,1,1,1,1,1,1,1,1,1,1,1,1,1,1
1,1,1,1,1,1,1,1,1,1,1,1,1,1,1,1,1,1,1,1,1,1,1,1,1,1,1,1,1,1,1,7,7,7,1,1,1,1,1,1,1,1,1,1,1,1,1,1,1,1,1,1,1,1,1,1,1,1,1,1,1,1,1,1
1,1,1,1,1,1,1,1,1,1,1,1,1,1,1,1,1,1,1,1,1,1,1,1,1,1,1,1,1,1,1,7,7,7,1,1,1,1,1,1,1,1,1,1,1,1,1,1,1,1,1,1,1,1,1,1,1,1,1,1,1,1,1,1
1,1,1,1,1,1,1,1,1,1,1,1,1,1,1,1,1,1,1,1,1,1,1,1,1,1,1,1,1,1,1,7,7,7,1,1,1,1,1,1,1,1,1,1,1,1,1,1,1,1,1,1,1,1,1,1,1,1,1,1,1,1,1,1
1,1,1,1,1,1,1,1,1,1,1,1,1,1,1,1,1,1,1,1,1,1,1,1,1,1,1,1,1,1,1,7,7,7,1,1,1,1,1,1,1,1,1,1,1,1,1,1,1,1,1,1,1,1,1,1,1,1,1,1,1,1,1,1
1,1,1,1,1,1,1,1,1,1,1,1,1,1,1,1,1,1,1,1,1,1,1,1,1,1,1,1,1,1,1,7,7,7,1,1,1,1,1,1,1,1,1,1,1,1,1,1,1,1,1,1,1,1,1,1,1,1,1,1,1,1,1,1
1,1,1,1,1,1,1,1,1,1,1,1,1,1,1,1,1,1,1,1,1,1,1,1,1,1,1,1,1,1,1,7,7,7,1,1,1,1,1,1,1,1,1,1,1,1,1,1,1,1,1,1,1,1,1,1,1,1,1,1,1,1,1,1
1,1,1,1,1,1,1,1,1,1,1,1,1,1,1,1,1,1,1,1,1,1,1,1,1,1,1,1,1,1,1,7,7,7,1,1,1,1,1,1,1,1,1,1,1,1,1,1,1,1,1,1,1,1,1,1,1,1,1,1,1,1,1,1
1,1,1,1,1,1,1,1,1,1,1,1,1,1,1,1,1,1,1,1,1,1,1,1,1,1,1,1,1,1,1,7,7,7,1,1,1,1,1,1,1,1,1,1,1,1,1,1,1,1,1,1,1,1,1,1,1,1,1,1,1,1,1,1
1,1,1,1,1,1,1,1,1,1,1,3,0,0,3,0,2,3,3,2,3,3,2,3,0,0,0,2,0,3,0,7,7,7,2,2,2,2,0,0,3,0,0,0,3,3,2,2,2,3,2,0,2,0,1,1,1,1,1,1,1,1,1,1
1,1,1,1,1,1,1,1,1,1,1,2,0,3,3,3,3,2,0,2,3,0,2,2,0,2,2,0,0,2,0,7,7,7,0,3,2,2,0,3,3,2,3,3,2,2,0,3,0,0,3,2,0,2,1,1,1,1,1,1,1,1,1,1
1,1,1,1,1,1,1,1,1,1,1,3,3,2,3,0,3,2,0,3,2,0,0,0,3,2,0,2,0,2,0,7,7,7,0,0,0,2,2,3,2,0,3,2,0,3,0,0,3,0,3,2,2,0,1,1,1,1,1,1,1,1,1,1
1,1,1,1,1,1,1,1,1,1,1,2,0,0,3,2,3,0,2,2,2,0,2,2,2,2,2,3,2,0,0,7,7,7,2,0,0,0,0,3,0,0,0,3,0,3,2,0,2,3,3,3,3,3,1,1,1,1,1,1,1,1,1,1
1,1,1,1,1,1,1,1,1,1,1,2,2,2,2,3,2,2,0,3,0,0,0,2,0,2,2,3,2,3,3,7,7,7,2,2,0,0,2,0,3,2,0,0,3,2,0,0,2,3,3,3,2,2,1,1,1,1,1,1,1,1,1,1
1,1,1,1,1,1,1,1,1,1,1,2,3,2,0,3,3,3,2,3,0,2,3,0,2,2,3,2,0,3,3,7,7,7,3,0,0,3,2,0,3,0,2,3,2,2,0,3,3,2,0,2,2,2,1,1,1,1,1,1,1,1,1,1
1,1,1,1,1,1,1,1,1,1,1,3,2,0,0,0,0,3,3,2,2,3,2,2,3,3,3,0,2,2,0,7,7,7,0,0,0,0,2,0,2,0,3,3,3,3,3,0,0,2,0,3,2,3,1,1,1,1,1,1,1,1,1,1
1,1,1,1,1,1,1,1,1,1,1,2,3,0,0,0,0,2,2,2,3,2,3,0,2,2,2,0,2,3,0,7,7,7,2,3,3,3,0,3,0,3,0,2,0,3,3,0,2,3,0,3,2,3,1,1,1,1,1,1,1,1,1,1
1,1,1,1,1,1,1,1,1,1,1,0,3,0,3,2,0,0,0,3,0,2,2,3,3,0,2,3,0,0,0,7,7,7,0,0,3,3,2,3,0,3,0,3,0,2,0,0,3,0,3,0,3,3,1,1,1,1,1,1,1,1,1,1
1,1,1,1,1,1,1,1,1,1,1,2,0,3,0,3,2,2,2,3,3,3,0,2,2,3,3,3,2,3,2,7,7,7,3,3,2,0,2,3,3,2,3,0,2,0,3,0,3,0,3,2,0,3,1,1,1,1,1,1,1,1,1,1
1,1,1,1,1,1,1,1,1,1,1,3,2,0,2,3,0,3,2,2,2,5,4,5,5,4,4,4,4,4,5,7,7,7,5,4,5,4,4,5,4,5,4,4,2,0,3,0,2,2,2,0,0,0,1,1,1,1,1,1,1,1,1,1
1,1,1,1,1,1,1,1,1,1,1,3,2,2,0,3,0,2,3,3,3,5,4,4,5,4,4,5,5,4,4,7,7,7,5,4,5,5,5,5,4,5,5,5,0,2,0,0,2,2,2,3,0,0,1,1,1,1,1,1,1,1,1,1
1,1,1,1,1,1,1,1,1,1,1,2,0,3,2,2,0,3,3,3,3,4,5,4,5,4,5,4,4,4,5,7,7,7,5,5,4,5,5,5,4,5,4,5,2,3,2,3,2,2,0,2,3,0,1,1,1,1,1,1,1,1,1,1
1,1,1,1,1,1,1,1,1,1,1,3,0,0,0,0,2,0,3,0,0,4,4,4,4,5,5,5,5,5,5,7,7,7,4,5,5,4,4,5,4,4,5,5,2,3,0,0,3,2,0,2,0,0,1,1,1,1,1,1,1,1,1,1
1,1,1,1,1,1,1,1,1,1,1,2,3,3,2,2,0,3,3,2,3,5,5,5,5,4,5,5,4,4,5,7,7,7,4,5,5,4,4,5,4,4,5,4,2,2,3,3,3,2,0,2,2,0,1,1,1,1,1,1,1,1,1,1
1,1,1,1,1,1,1,1,1,1,1,2,0,2,2,3,0,2,3,0,0,4,5,5,4,5,5,5,5,4,5,7,7,7,4,4,5,5,5,4,4,5,5,5,0,3,3,3,2,2,0,2,3,3,1,1,1,1,1,1,1,1,1,1
1,1,1,1,1,1,1,1,1,1,1,0,3,2,0,0,3,2,3,3,0,5,5,4,5,4,4,4,5,5,4,7,7,7,4,4,4,4,5,5,4,4,5,4,0,2,3,3,2,0,2,3,2,2,1,1,1,1,1,1,1,1,1,1
1,1,1,1,1,1,1,1,1,1,1,3,0,2,2,0,2,2,3,3,3,4,5,5,5,4,5,4,4,5,5,7,7,7,4,5,4,4,4,4,5,5,4,4,3,2,3,0,0,3,2,2,2,3,1,1,1,1,1,1,1,1,1,1
1,1,1,1,1,1,1,1,1,1,1,3,3,0,2,2,0,0,3,2,2,4,4,5,5,4,5,4,5,4,4,7,7,7,4,4,5,4,4,5,5,4,5,4,0,2,3,0,3,3,0,0,0,3,1,1,1,1,1,1,1,1,1,1
1,1,1,1,1,1,1,1,1,1,1,3,3,3,0,0,2,2,0,0,0,5,5,4,5,5,5,5,5,5,5,7,7,7,5,4,4,4,5,4,4,4,4,5,2,0,3,3,3,2,0,3,3,2,1,1,1,1,1,1,1,1,1,1
1,7,7,7,7,7,7,7,7,7,7,7,7,7,7,7,7,7,7,7,7,7,7,7,7,7,7,7,7,7,7,7,7,7,7,7,7,7,7,7,7,7,7,7,7,7,7,7,7,7,7,7,7,7,7,7,7,7,7,7,7,7,7,1
1,7,7,7,7,7,7,7,7,7,7,7,7,7,7,7,7,7,7,7,7,7,7,7,7,7,7,7,7,7,7,7,7,7,7,7,7,7,7,7,7,7,7,7,7,7,7,7,7,7,7,7,7,7,7,7,7,7,7,7,7,7,7,1
1,7,7,7,7,7,7,7,7,7,7,7,7,7,7,7,7,7,7,7,7,7,7,7,7,7,7,7,7,7,7,7,7,7,7,7,7,7,7,7,7,7,7,7,7,7,7,7,7,7,7,7,7,7,7,7,7,7,7,7,7,7,7,1
1,1,1,1,1,1,1,1,1,1,1,0,0,0,0,2,3,2,0,0,3,5,5,5,4,4,5,5,4,4,4,7,7,7,4,4,4,4,5,5,4,4,5,4,2,0,0,2,2,3,2,3,2,0,1,1,1,1,1,1,1,1,1,1
1,1,1,1,1,1,1,1,1,1,1,0,3,2,2,0,3,0,0,0,2,4,5,4,4,5,4,4,4,5,4,7,7,7,4,4,4,5,4,4,5,4,4,4,2,3,2,0,0,2,3,3,3,2,1,1,1,1,1,1,1,1,1,1
1,1,1,1,1,1,1,1,1,1,1,2,0,3,3,0,0,0,2,2,0,5,4,5,4,4,5,4,5,4,5,7,7,7,4,5,4,4,5,4,4,4,4,5,3,0,0,2,0,0,0,3,0,0,1,1,1,1,1,1,1,1,1,1
1,1,1,1,1,1,1,1,1,1,1,0,0,2,0,3,0,0,3,0,2,5,4,4,5,4,5,5,4,5,5,7,7,7,5,4,4,5,5,5,5,4,4,5,2,2,0,2,3,3,3,2,0,0,1,1,1,1,1,1,1,1,1,1
1,1,1,1,1,1,1,1,1,1,1,0,2,3,0,3,2,0,0,0,0,4,5,4,4,4,5,5,4,4,5,7,7,7,5,5,5,5,4,4,4,5,5,4,0,2,2,2,2,0,3,3,2,2,1,1,1,1,1,1,1,1,1,1
1,1,1,1,1,1,1,1,1,1,1,2,2,2,0,0,2,3,2,3,3,5,4,5,5,4,4,5,4,5,4,7,7,7,5,5,4,4,5,5,5,5,4,5,2,3,3,3,3,2,2,2,2,3,1,1,1,1,1,1,1,1,1,1
1,1,1,1,1,1,1,1,1,1,1,0,2,0,0,0,0,2,2,0,2,4,5,5,5,5,4,5,5,4,5,7,7,7,5,4,5,4,4,5,5,4,5,5,3,0,2,3,2,0,0,0,2,0,1,1,1,1,1,1,1,1,1,1
1,1,1,1,1,1,1,1,1,1,1,3,0,3,3,0,2,3,2,0,0,4,5,5,5,5,5,5,5,4,5,7,7,7,4,5,4,4,4,4,4,5,5,4,3,2,3,3,2,0,2,2,2,3,1,1,1,1,1,1,1,1,1,1
1,1,1,1,1,1,1,1,1,1,1,2,3,3,0,0,3,2,2,3,3,5,4,5,5,5,5,5,4,5,5,7,7,7,5,4,4,4,5,4,5,4,5,5,3,3,0,2,2,3,2,0,2,2,1,1,1,1,1,1,1,1,1,1
1,1,1,1,1,1,1,1,1,1,1,0,0,2,3,3,2,2,2,3,3,5,4,5,4,4,5,5,4,4,5,7,7,7,4,4,5,5,4,5,5,5,5,4,0,2,2,0,0,3,3,2,3,0,1,1,1,1,1,1,1,1,1,1
1,1,1,1,1,1,1,1,1,1,1,2,2,3,3,3,0,2,3,3,0,2,3,2,0,3,2,3,2,3,0,7,7,7,0,2,2,2,0,2,2,0,3,2,0,3,2,3,0,2,0,0,3,2,1,1,1,1,1,1,1,1,1,1
1,1,1,1,1,1,1,1,1,1,1,3,2,3,2,0,3,3,2,0,3,2,0,3,2,2,3,3,3,0,2,7,7,7,3,3,0,0,0,0,3,2,2,3,0,3,2,2,2,2,2,3,2,3,1,1,1,1,1,1,1,1,1,1
1,1,1,1,1,1,1,1,1,1,1,2,2,3,2,2,2,0,2,0,3,3,3,0,2,0,2,2,0,2,0,7,7,7,3,3,3,0,2,2,2,3,2,3,2,3,0,3,3,3,3,3,0,0,1,1,1,1,1,1,1,1,1,1
1,1,1,1,1,1,1,1,1,1,1,2,2,3,2,3,2,3,0,2,3,0,3,0,3,2,0,3,2,2,2,7,7,7,2,0,3,3,0,3,3,2,0,0,3,3,0,0,2,0,3,2,0,2,1,1,1,1,1,1,1,1,1,1
1,1,1,1,1,1,1,1,1,1,1,2,0,0,2,0,2,3,2,2,2,0,2,2,2,0,0,3,3,2,3,7,7,7,2,3,0,2,3,3,2,3,3,3,2,3,3,0,0,3,2,0,0,0,1,1,1,1,1,1,1,1,1,1
1,1,1,1,1,1,1,1,1,1,1,0,0,3,0,2,0,2,3,0,0,3,3,0,0,0,2,0,3,0,2,7,7,7,3,0,3,3,0,3,2,0,2,3,3,3,0,2,2,2,2,0,2,0,1,1,1,1,1,1,1,1,1,1
1,1,1,1,1,1,1,1,1,1,1,0,3,3,3,3,0,3,2,3,0,2,3,3,2,3,0,2,2,3,3,7,7,7,3,2,0,2,3,0,3,2,3,3,3,0,2,2,3,2,2,0,0,2,1,1,1,1,1,1,1,1,1,1
1,1,1,1,1,1,1,1,1,1,1,0,0,3,3,0,2,3,0,3,0,2,3,3,2,2,2,2,3,3,0,7,7,7,3,0,0,0,2,3,3,3,2,0,3,2,0,3,0,2,0,2,3,3,1,1,1,1,1,1,1,1,1,1
1,1,1,1,1,1,1,1,1,1,1,3,2,3,2,2,3,3,2,3,0,3,3,3,2,2,3,2,2,2,3,7,7,7,3,0,3,2,3,0,3,2,0,3,0,2,3,3,0,3,2,3,0,0,1,1,1,1,1,1,1,1,1,1
1,1,1,1,1,1,1,1,1,1,1,0,0,2,0,3,0,3,0,2,0,3,0,2,2,3,0,0,3,2,0,7,7,7,0,3,2,0,0,3,2,0,2,0,2,3,2,0,3,2,3,2,0,2,1,1,1,1,1,1,1,1,1,1
1,1,1,1,1,1,1,1,1,1,1,1,1,1,1,1,1,1,1,1,1,1,1,1,1,1,1,1,1,1,1,7,7,7,1,1,1,1,1,1,1,1,1,1,1,1,1,1,1,1,1,1,1,1,1,1,1,1,1,1,1,1,1,1
1,1,1,1,1,1,1,1,1,1,1,1,1,1,1,1,1,1,1,1,1,1,1,1,1,1,1,1,1,1,1,7,7,7,1,1,1,1,1,1,1,1,1,1,1,1,1,1,1,1,1,1,1,1,1,1,1,1,1,1,1,1,1,1
1,1,1,1,1,1,1,1,1,1,1,1,1,1,1,1,1,1,1,1,1,1,1,1,1,1,1,1,1,1,1,7,7,7,1,1,1,1,1,1,1,1,1,1,1,1,1,1,1,1,1,1,1,1,1,1,1,1,1,1,1,1,1,1
1,1,1,1,1,1,1,1,1,1,1,1,1,1,1,1,1,1,1,1,1,1,1,1,1,1,1,1,1,1,1,7,7,7,1,1,1,1,1,1,1,1,1,1,1,1,1,1,1,1,1,1,1,1,1,1,1,1,1,1,1,1,1,1
1,1,1,1,1,1,1,1,1,1,1,1,1,1,1,1,1,1,1,1,1,1,1,1,1,1,1,1,1,1,1,7,7,7,1,1,1,1,1,1,1,1,1,1,1,1,1,1,1,1,1,1,1,1,1,1,1,1,1,1,1,1,1,1
1,1,1,1,1,1,1,1,1,1,1,1,1,1,1,1,1,1,1,1,1,1,1,1,1,1,1,1,1,1,1,7,7,7,1,1,1,1,1,1,1,1,1,1,1,1,1,1,1,1,1,1,1,1,1,1,1,1,1,1,1,1,1,1
1,1,1,1,1,1,1,1,1,1,1,1,1,1,1,1,1,1,1,1,1,1,1,1,1,1,1,1,1,1,1,7,7,7,1,1,1,1,1,1,1,1,1,1,1,1,1,1,1,1,1,1,1,1,1,1,1,1,1,1,1,1,1,1
1,1,1,1,1,1,1,1,1,1,1,1,1,1,1,1,1,1,1,1,1,1,1,1,1,1,1,1,1,1,1,7,7,7,1,1,1,1,1,1,1,1,1,1,1,1,1,1,1,1,1,1,1,1,1,1,1,1,1,1,1,1,1,1
1,1,1,1,1,1,1,1,1,1,1,1,1,1,1,1,1,1,1,1,1,1,1,1,1,1,1,1,1,1,1,7,7,7,1,1,1,1,1,1,1,1,1,1,1,1,1,1,1,1,1,1,1,1,1,1,1,1,1,1,1,1,1,1
1,1,1,1,1,1,1,1,1,1,1,1,1,1,1,1,1,1,1,1,1,1,1,1,1,1,1,1,1,1,1,1,1,1,1,1,1,1,1,1,1,1,1,1,1,1,1,1,1,1,1,1,1,1,1,1,1,1,1,1,1,1,1,1